11111111
100000E1
10000001
100000C1
11100111
100PCC01
10000001
10CCCC01
11111111
