11111111
100000E1
11110001
100000C1
10000001
100PCC01
10000001
10CCCC01
11111111
