11111111
100000E1
10000001
100000C1
11100111
10000001
10000001
1P000001
11111111
